111111111111111111111111111
1111111C0000000000000000001
100000000000000000000000001
100000000000000000011C00001
100000000000000000111110001
10000C000000000000111000001
1110000000000000001000001E1
111111111111110000000000111
100000001111111111000000001
100C00000000000000000000001
111110000000000000000000001
1C0000011110000000000000001
111000010110000000000011101
11000000011000000000001C101
100010000C100000000000001P1
111111111111111111111111111