1111111111111
1001P0000P0C1
1000011111001
1P0011E00P001
1111111111111