111111111111111111111111111111111111111111111111111111111111111111111111111111111111111111111111111111111111
1111111C00000000000000000011111111C00000000000000000011111111C00000000000000000011111111C0000000000000000001
100000000000000000000000001100000000000000000000000001100000000000000000000000001100000000000000000000000001
100000000000000000011C00000000000000000000000011C00000000000000000000000011C00000000000000000000000011C00001
100000000000000000111110000000000000000000000111110000000000000000000000111110000000000000000000000111110001
10000C00000000000011100000110000C00000000000011100000110000C00000000000011100000110000C000000000000111000001
1110000000000000001000001E1111000000000000000100000111111000000000000000100000111111000000000000000100000111
111111111111110000000000111111111111111110000000000111111111111111110000000000111111111111111110000000000111
100000001111111111000000001100000001111111111000000001100000001111111111000000001100000001111111111000000001
100C00000000000000000000000000C00000000000000000000000000C00000000000000000000000000C00000000000000000000001
111110000000000000000000001111110000000000000000000001111110000000000000000000001111110000000000000000000001
1C00000111100000000000000011C00000111100000000000000011C00000111100000000000000011C0000011110000000000000001
111000010110000000000011101111000010110000000000011101111000010110000000000011101111000010110000000000011101
11000000011000000000001C10111000000011000000000001C10111000000011000000000001C10111000000011000000000001C101
100010000C100000000000001P1100010000C10000000000000111100010000C10000000000000111100010000C10000000000000111
1111111C00000000000000000011111111C00000000000000000011111111C00000000000000000011111111C0000000000000000001
100000000000000000000000001100000000000000000000000001100000000000000000000000001100000000000000000000000001
100000000000000000011C00000000000000000000000011C00000000000000000000000011C00000000000000000000000011C00001
100000000000000000111110000000000000000000000111110000000000000000000000111110000000000000000000000111110001
10000C00000000000011100000110000C00000000000011100000110000C00000000000011100000110000C000000000000111000001
111000000000000000100000101111000000000000000100000111111000000000000000100000111111000000000000000100000111
111111111111110000000000111111111111111110000000000111111111111111110000000000111111111111111110000000000111
100000001111111111000000001100000001111111111000000001100000001111111111000000001100000001111111111000000001
100C00000000000000000000000000C00000000000000000000000000C00000000000000000000000000C00000000000000000000001
111110000000000000000000001111110000000000000000000001111110000000000000000000001111110000000000000000000001
1C00000111100000000000000011C00000111100000000000000011C00000111100000000000000011C0000011110000000000000001
111000010110000000000011101111000010110000000000011101111000010110000000000011101111000010110000000000011101
11000000011000000000001C10111000000011000000000001C10111000000011000000000001C10111000000011000000000001C101
100010000C10000000000000101100010000C10000000000000111100010000C10000000000000111100010000C10000000000000111
1111111C00000000000000000011111111C00000000000000000011111111C00000000000000000011111111C0000000000000000001
100000000000000000000000001100000000000000000000000001100000000000000000000000001100000000000000000000000001
100000000000000000011C00000000000000000000000011C00000000000000000000000011C00000000000000000000000011C00001
100000000000000000111110000000000000000000000111110000000000000000000000111110000000000000000000000111110001
10000C00000000000011100000110000C00000000000011100000110000C00000000000011100000110000C000000000000111000001
111000000000000000100000101111000000000000000100000111111000000000000000100000111111000000000000000100000111
111111111111110000000000111111111111111110000000000111111111111111110000000000111111111111111110000000000111
100000001111111111000000001100000001111111111000000001100000001111111111000000001100000001111111111000000001
100C00000000000000000000000000C00000000000000000000000000C00000000000000000000000000C00000000000000000000001
111110000000000000000000001111110000000000000000000001111110000000000000000000001111110000000000000000000001
1C00000111100000000000000011C00000111100000000000000011C00000111100000000000000011C0000011110000000000000001
111000010110000000000011101111000010110000000000011101111000010110000000000011101111000010110000000000011101
11000000011000000000001C10111000000011000000000001C10111000000011000000000001C10111000000011000000000001C101
100010000C10000000000000101100010000C10000000000000111100010000C10000000000000111100010000C10000000000000111
111111111111111111111111111111111111111111111111111111111111111111111111111111111111111111111111111111111111